2222222222222222222222222
4000000000000000000000005
4000000000000000000000005
4000000000000000000000005
4000000000000000000000005
4000000000000000000000005
4000666600000000000000005
4000000000000000000000005
4000000000000000070000005
4000000000000000000000005
4000000000006060000000005
0000000000000000000000000
0000000000000000000000000
0000000000006000000000000
4000000000007000000000005
4000000000007000000000005
4000000000000000000000005
4000000000000000000000005
4000000000000000000000005
4000000000000000000000005
4000707000000000000000005
4000000000000000000000005
4000000000000000066000005
4000000000000000000000005
3333333333300033333333333