2222222222200022222222222
4000000000000000000000005
4000000000000770000000005
4000000000000000000000005
4000000000000000000000005
4000000000000000000000005
4000000000660000000700005
4000000000000000000000005
4000060000000000000000005
4000000000000000000000005
4000000000000600000000005
0000000000000000000000000
0000700000000000000000000
0000700000000000000000000
4000000000000000000000005
4000000000000000000060005
4000000000000000000000005
4000000000000000000600005
4000000000000000000000005
4000000000006600000000005
4000000000000000000000005
4000000000000000000000005
4000000000000000000770005
4000000000000000000000005
3333333333300033333333333