2222222222200022222222222
4000000000000000000000005
4000000000000000000000005
4000000000000000000000005
4000000000000000000000005
4000000000000000666000005
4000000000000000000000005
4000000000000000000000005
4000700000000000000000005
4000000000000000000670005
4000000000000000000000005
4000000000000000000000000
4000000000000000000000000
4000000000000000000000000
4000000000000000000000005
4000000000000000000000005
4000007000000000000000005
4000000000000000000000005
4000000000000000000000005
4000000000000000070000005
4000000000000000000000005
4000000000000000000000005
4000000000000000006000005
4000000000000000000000005
3333333333333333333333333