2222222222200022222222222
4000000000000000000000005
4000000000000000000000005
4000000000000000000000005
4000000000000000007000005
4000000000000000000000005
4000000000000000000000005
4000000000060000000000005
4000000000000000000000005
4000000000000000070000005
4000000000000000000000005
0000000000000006000000000
0000000000000000000000000
0000000000000000000000000
4000000000000000000000005
4000000000000000000000005
4000000000000000000000005
4000006600000000007700005
4000000000000000000000005
4000000000000000000000005
4000000000000000000000005
4000000000000700000000005
4000000000000000000000005
4000000000000000000000005
3333333333333333333333333