2222222222200022222222222
4000000000000000000000005
4000000000000000000000005
4006007000000000000000005
4000000000000000000000005
4000000000000000000000005
4000000000000000000006005
4000000000000000000007005
4000000000000000000006005
4000000000000000000000005
4000000000000000000000005
0000000000000000000000005
0000000600000000000000005
0000000600000000000000005
4000000000000000000000005
4000000000000000000000005
4000000000000000000000005
4000000000000000000000005
4000000000000000000000005
4000000000000000000000005
4000007000000000000000005
4000000000000000000000005
4000000000000000600000005
4000000000000000000000005
3333333333300033333333333