2222222222222222222222222
4000000000000000000000005
4000000000000000000000005
4000000000000000000000005
4000000000000000000000005
4000000000000000000000005
4000000000000000000000005
4000000000000000000000005
4000000000000000000000005
4000000000000000000000005
4000000000000000000000005
0000000000000000000000005
0000000000000000000000005
0000000000000000000000005
4000000000000000000000005
4000000000000000000000005
4000000000000000000000005
4000000000000000000000005
4000000000000000000000005
4000000000000000000000005
4000000000000000000000005
4000000000000000000000005
4000000000000000000000005
4000000000000000000000005
3333333333300033333333333