2222222222200022222222222
4000000000000000000000005
4000000000000000000000005
4000000000000000000000005
4000000000000000000000005
4000000000000000000000005
4000000000000000000000005
4000000000000000000000005
4000000000000000000000005
4000000000000000000000005
4000000000000000000000005
0000000000000000000000000
0000000000000000000000000
0000000000000000000000000
4000000000000000000000005
4000000000000000000000005
4000000000000000000000005
4000000000000000000000005
4000000000000000000000005
4000000000000000000000005
4000000000000000000000005
4000000000000000000000005
4000000000000000000000005
4000000000000000000000005
3333333333333333333333333